111111111111111111111
1000000C0C0000C0000P1
100111111111111111111
100000000C00000000001
111111111111111111001
100C00010001000100001
100000010001010100001
100001000100110001111
1E0001010100010011001
111111111111111111111